w                              w
w                              w
w                              w
w                              w
w                              w
w                              w
w                              w
w                              w
w                              w
w                              w
w                              w
w                     w        w
w                     t        w
w                              w
w                              w
w s       k    w               w
w  w  n   w   www            wew
wwwwwwwwwwwwwwwww wwwwwwwwww www
